##BBBBBBBBBBBBBBBB##
#SSSSSSSSSBSSSSSSSS#
#BSBSBBBBSBSBBBBBBS#
#BSBSBBBBSBSBBBBBBS#
#SSSSSSSSSSSSSSSSSS#
#BSBBBBBBBSBBSBBSBB#
#BSSSSSSSSSSSSSSSSB#
WWWWSWWWWWWWWWSWWWWW
#BSSSSSSSSSSSSSSSSS#
#BSBSBBBSBBBBSBBBBS#
#BSBSBBBSBBBBSBBBBS#
#BBBSSSSSSSSSSSSSSS#
#BBBSBBBSBBBBSBBBBS#
#BBBSBBBSBBBBSBBBBS#
#BBBSSSSSSSSSSSSSSS#
#SSSSBBBSBBBBBSBBSB#
#BBBSBBBSBBBBBSBBSB#
#BSSSSSSSSSSBBBBBBB#
#SSBBBBBBBBSSSSSSSS#
####################